10 10 4
WWWWWWWWWW
WS  W W WW
W W W W WW
W W   W WW
W WWWWW WW
W    W   W
WWWW W W W
WWW  W W W
WW# WW   W
WWWWWWWWWW

WWWWWWWWWW
WWWW WWWWW
W#    WWWW
WWWWW    W
W     WW W
WWWWWW   W
W    W W W
W#WW W WWW
WW#     WW
WWWWWWWWWW

WWWWWWWWWW
W  # WWWWW
W#WW W   W
W  W W W W
WWWW   W W
WWWW WW# W
W WW W  WW
W#WW WWW#W
W    WX  W
WWWWWWWWWW

WWWWWWWWWW
WWW#WW   W
WWW    W W
WW   WW  W
W  WW   WW
W   W  #WW
WWW WWWW W
WW      #W
WWWWWWWW W
WWWWWWWWWW